w w w w w w w w w w
w w w w w w w w w w
w w p e w e e e w w
w w e e w s e e w w
w w e e w e b e w w
w w w e b e w w w w
w w w e e e w w w w
w w w s e e w w w w
w w w w w w w w w w
w w w w w w w w w w