w w w w w w w w w w
w w e e w e e p w w
w w b e e b e e w w
w w e w w e b e w w
w w s s s b e w w w
w e s s s w e w w w
w e w b b e e w w w
w e e e e e e w w w
w w w w w w w w w w
w w w w w w w w w w