w w w w w w w w w w
w w w w w w w w w w
w w w w p e w w w w
w w w e b e w w w w
w w w e e e w w w w
w w w w e e w w w w
w w w w b s w w w w
w w w w e s w w w w
w w w w w w w w w w
w w w w w w w w w w