w w w w w w w w w w
w w w w w w w w w w
w w w w w w w w w w
w w w s e e e w w w
w w w b b e e w w w
w w w p s w w w w w
w w w w w w w w w w
w w w w w w w w w w
w w w w w w w w w w
w w w w w w w w w w