w w w w w w w w w w
w w w w w w w w w w
w w w w w w w w w w
w w w w w e e e w w
w w p b e e w e w w
w w s e b e e s w w
w w w w w w w w w w
w w w w w w w w w w
w w w w w w w w w w
w w w w w w w w w w