w w w w w w w w w w
w w w w w w w w w w
w w w e e e w s e w
w w w e e b s s s w
w w p e b e w r s w
w w e w w b w e w w
w e e b e e b e e w
w e e e w e e e e w
w w w w w w w e e w
w w w w w w w w w w