w w w w w w w w w w
w w w w w w w w w w
w w w w w w w w w w
w w e e s w e e w w
w w e e b p b e w w
w w e e w w e s w w
w w w w w w w w w w
w w w w w w w w w w
w w w w w w w w w w
w w w w w w w w w w