w w w w w w w w w w
w w w w w w w w w w
w w w w w w w w w w
w w e e e e e e w w
w w e p e e e e w w
w w e e e e b s w w
w w e e e s b e w w
w w w w w w w w w w
w w w w w w w w w w
w w w w w w w w w w