w w w w w w w w w w
w w w w w w w w w w
w w w p e w w w w w
w w w e b e e w w w
w w w w e w e w w w
w w s w e w e e w w
w w s b e e w e w w
w w s e e e b e w w
w w w w w w w w w w
w w w w w w w w w w